0 0
29 19
30 20
115 119 119 119 119 119 119 119 119 119 119 119 119 35 119 119 119 119 119 119 119 119 119 119 119 119 35 119 119 119 
119 119 119 119 119 119 119 119 119 35 119 119 119 35 35 119 119 119 35 119 119 119 119 119 35 35 119 119 119 119 
119 119 119 119 35 35 119 35 119 119 119 119 119 119 119 35 119 119 119 35 119 119 119 119 119 119 119 119 119 119 
119 119 119 119 35 119 119 119 119 119 119 119 119 119 119 119 119 35 119 35 119 119 119 119 35 119 119 119 119 119 
119 119 119 119 35 119 119 119 119 119 119 35 35 35 119 119 35 119 119 119 119 119 119 35 119 119 119 119 119 119 
119 119 119 119 35 119 119 119 119 119 35 119 119 119 119 119 119 119 119 35 119 119 119 119 35 119 119 119 119 119 
119 119 119 119 119 119 119 119 119 119 119 35 119 119 119 35 119 119 119 35 119 119 119 119 35 35 35 119 119 119 
119 119 119 119 119 119 119 119 119 119 119 35 119 119 119 119 119 119 119 119 119 119 35 119 35 119 119 119 119 119 
119 119 119 119 119 119 119 119 119 119 119 35 119 119 119 119 119 35 119 35 119 35 119 119 119 35 119 119 119 119 
119 119 119 119 119 119 35 119 35 35 119 35 119 119 35 119 119 119 119 119 119 119 119 119 119 35 119 35 119 119 
119 119 119 119 119 35 119 119 119 119 119 119 119 119 119 119 119 119 119 119 119 35 119 119 119 35 119 119 119 119 
119 119 119 119 119 35 119 119 119 35 119 119 119 119 35 119 119 119 119 35 119 119 119 35 35 119 119 119 119 119 
119 119 119 119 119 35 119 119 35 119 119 119 119 119 35 35 35 119 119 119 35 119 119 119 119 35 119 35 119 119 
119 119 119 119 119 35 119 119 119 35 119 119 119 119 35 119 119 35 119 119 119 35 35 35 35 119 119 119 119 119 
119 119 119 119 119 35 119 119 119 119 119 119 35 119 35 119 119 35 35 35 35 119 119 119 119 119 119 119 119 119 
119 119 35 35 35 35 119 119 119 119 119 119 119 119 119 35 119 119 119 119 119 119 119 119 119 119 119 119 119 119 
119 35 35 119 119 119 119 119 119 119 119 119 119 119 119 119 35 119 119 119 119 119 35 119 119 119 119 119 119 119 
119 119 119 119 119 119 119 119 119 35 119 119 35 119 119 119 119 119 119 119 119 119 119 119 119 35 119 119 119 119 
119 119 119 119 35 35 119 35 119 119 119 119 119 119 119 119 119 119 119 119 35 119 35 35 35 35 119 119 119 119 
119 119 119 119 119 119 119 119 119 119 119 119 119 119 119 119 119 35 35 119 119 119 119 119 119 119 119 119 119 101 
